WE ./textures/wall_1.xpm
SO ./textures/wall_2.xpm
EA ./textures/wall_3.xpm
NO ./textures/wall_4.xpm
F 133,117,92
C 82,39,16
1111111111111111111111111111111111111111111111111111111111111111111111111
100010000000000000001000000000000000100000000000100000000000D000000010001
100011D1111111111000100011111000111111111000111111D1111111D11111100010001
1000D0000000000010000000100010000000000010000000D000100010001000000010001
11111111100010001111111111D1111111111000111110001000100010001111111110001
100000001000100000000000D000100000000000100010001000100010000000000010001
100010001111111111111000100010001111111110001111100011D111111111100010001
1000100000000000000010001000100000001000000000001000D00000001000000010001
1000111111111111100011111000111110001000111111D11111111110001000111110001
100000000000100000001000100000001000100000001000D000000010001000000000001
1000111110001111100010001111100010001111111110001000100010001111111111111
1000000010000000100010001000D00010000000100000001000100010000000100000001
1111111111111000100011D11000111111111000100011111000100011111000111110001
100000000000100010000000D000100000001000100000001000100000001000000000001
1000111110001000111111111000111110001000111110001111100011111111111110001
1000100000001000000000001000000000001000000010001000100000000000000010001
10001000111111111000100011111000111111111000100011D1111111111111100010001
100010000000000010001000100010001000000000001000D000000000000000100000001
1000111111111000100010001000111110001111111110001111111111D111D1111111111
10N0100000001000100010000000000010000000000010001000000010000000D000D0001
10001000111111D1111111D1111110001111111111D11111100010001111111111D110001
100010000000D0000000000010000000D0001000D00D00000000100000000000000010001
1111111111111111111111111111111111111111111111111111111111111111111111111